o w w w w w w w w w w w w o
o 0 0 0 0 0 0 0 0 0 0 0 0 o
o 0 0 0 0 0 0 0 0 0 0 0 0 o
o 0 0 0 0 0 0 0 0 0 0 0 0 o
v 0 0 0 0 0 0 0 0 0 0 0 0 o
s 0 0 0 0 0 0 0 0 0 0 0 0 o
s 0 0 0 0 0 0 0 0 0 0 0 0 o
b 0 0 0 0 0 0 0 0 0 0 0 0 o
o x x x x x x x x x x x x o